####################
#S     #           #
###### ####### #####
#              #  X#
#  *           3   #
#######1###2########
#       #        ###
#       #          #
#    %  #     &    #
#       #          #
####################

1*
2%
3&