#########
#   #   #
S $ 1   #
#   #   #
#####   #
#   #   #
#   2   #
# % #####
#      X#
#########

1%
2$