#############X##
S       #%#    #
#  #*   # ####2#
#  ###  #      #
#  #    # ######
#       1      #
################

7p
1*
6&
2%
3o
